1111111111
0000000000
0000000000
1000000000
1F0000000P
1000000000
0000000000
0000000000
0000000000
1111111111
