1000000000
0100000000
0010000000
0001000000
00001F0000
0000010000
00000P1000
0000000100
0000000010
0000000001
